1111111111111111111
1111110011111111111
1111110C11111111111
1000CP000C00000C001
1000000000000000001
1C0000C00000C000001
1000C11111111000001
111111111111100C111
1111111111111E11111
1111111111111111111
